1,1,1,1,1,1,1,1,1,1,1,1,1,1,1,1,1,1,1,1,1,1,1,1,1,1,1,1,1,1,1,1,1
1,0,0,0,0,0,0,0,0,0,0,0,0,0,0,0,0,0,0,0,0,0,0,0,0,0,0,0,0,0,0,0,1
1,0,1,1,1,0,1,1,1,1,1,1,1,0,1,1,1,1,1,0,1,1,1,1,1,1,1,0,1,1,1,0,1
1,0,1,5,1,0,1,5,5,5,5,5,1,0,1,5,5,5,1,0,1,5,5,5,5,5,1,0,1,5,1,0,1
1,0,1,5,1,0,1,5,5,5,5,5,1,0,1,5,5,5,1,0,1,5,5,5,5,5,1,0,1,5,1,0,1
1,0,1,5,1,0,1,5,5,5,5,5,1,0,1,5,5,5,1,0,1,5,5,5,5,5,1,0,1,5,1,0,1
1,0,1,5,1,0,1,1,1,1,1,1,1,0,1,1,1,1,1,0,1,1,1,1,1,1,1,0,1,5,1,0,1
1,0,1,5,1,0,0,0,0,0,0,0,0,0,0,0,0,0,0,0,0,0,0,0,0,0,0,0,1,5,1,0,1
1,0,1,1,1,0,1,1,1,0,1,1,1,1,1,1,0,1,1,1,1,1,1,0,1,1,1,0,1,1,1,0,1
1,0,0,0,0,0,1,5,1,0,1,5,5,5,5,1,0,1,5,5,5,5,1,0,1,5,1,0,0,0,0,0,1
1,0,1,1,1,0,1,1,1,0,1,1,1,1,1,1,0,1,1,1,1,1,1,0,1,1,1,0,1,1,1,0,1
1,0,1,5,1,0,0,0,0,0,0,0,0,0,0,0,0,0,0,0,0,0,0,0,0,0,0,0,1,5,1,0,1
1,0,1,5,1,1,1,0,1,1,1,1,0,1,1,1,1,1,1,1,0,1,1,1,1,0,1,1,1,5,1,0,1
1,0,1,5,5,5,1,0,1,5,5,1,0,0,0,0,0,0,0,0,0,1,5,5,1,0,1,5,5,5,1,0,1
1,0,1,1,1,1,1,0,1,5,5,1,0,1,1,1,1,1,1,1,0,1,5,5,1,0,1,1,1,1,1,0,1
8,0,0,0,0,0,0,0,1,5,5,1,0,1,4,2,4,2,4,1,0,1,5,5,1,0,0,0,0,0,0,0,9
1,0,1,1,1,1,1,0,1,5,5,1,0,1,4,4,4,4,4,1,0,1,5,5,1,0,1,1,1,1,1,0,1
1,0,1,5,5,5,1,0,1,5,5,1,0,1,4,2,4,2,4,1,0,1,5,5,1,0,1,5,5,5,1,0,1
1,0,1,5,5,5,1,0,1,5,5,1,0,1,1,1,1,1,1,1,0,1,5,5,1,0,1,5,5,5,1,0,1
1,0,1,5,5,5,1,0,1,5,5,1,0,0,0,0,0,0,0,0,0,1,5,5,1,0,1,5,5,5,1,0,1
1,0,1,5,1,1,1,0,1,1,1,1,0,1,1,1,1,1,1,1,0,1,1,1,1,0,1,1,1,5,1,0,1
1,0,1,5,1,0,0,0,0,0,0,0,0,0,0,0,0,0,0,0,0,0,0,0,0,0,0,0,1,5,1,0,1
1,0,1,1,1,0,1,1,1,0,1,1,1,1,1,1,0,1,1,1,1,1,1,0,1,1,1,0,1,1,1,0,1
1,0,0,0,0,0,1,5,1,0,1,5,5,5,5,1,0,1,5,5,5,5,1,0,1,5,1,0,0,0,0,0,1
1,0,1,1,1,0,1,1,1,0,1,1,1,1,1,1,0,1,1,1,1,1,1,0,1,1,1,0,1,1,1,0,1
1,0,1,5,1,0,0,0,0,0,0,0,0,0,0,0,0,0,0,0,0,0,0,0,0,0,0,0,1,5,1,0,1
1,0,1,5,1,0,1,1,1,1,1,1,1,1,1,1,0,1,1,1,1,1,1,1,1,1,1,0,1,5,1,0,1
1,0,1,5,1,0,1,5,5,5,5,5,5,5,5,1,0,1,5,5,5,5,5,5,5,5,1,0,1,5,1,0,1
1,0,1,5,1,0,1,5,5,5,5,5,5,5,5,1,0,1,5,5,5,5,5,5,5,5,1,0,1,5,1,0,1
1,0,1,5,1,0,1,5,5,5,5,5,5,5,5,1,0,1,5,5,5,5,5,5,5,5,1,0,1,5,1,0,1
1,0,1,1,1,0,1,1,1,1,1,1,1,1,1,1,0,1,1,1,1,1,1,1,1,1,1,0,1,1,1,0,1
1,0,0,0,0,0,0,0,0,0,0,0,0,0,0,0,0,0,0,0,0,0,0,0,0,0,0,0,0,0,0,0,1
1,1,1,1,1,1,1,1,1,1,1,1,1,1,1,1,1,1,1,1,1,1,1,1,1,1,1,1,1,1,1,1,1
